Guess the number/With feedback (player)	False	None
Loops/Break	False	Break_statement
Guess the number/With feedback	False	None
Abstract type	False	Abstract_type
Benford's law	True	Benford%27s_law
Jensen's Device	True	Jensen%27s_Device
Perfect numbers	True	Perfect_number
First-class functions/Use numbers analogously	False	None
K-d tree	True	K-d_tree
CSV to HTML translation	False	None
Canny edge detector	True	Canny_edge_detector
MD5	True	MD5
Bitwise operations	False	Bitwise_operation
Fibonacci n-step number sequences	True	Fibonacci_number
Call an object method	False	Object-oriented_programming
Infinity	False	Infinity
Machine code	False	Machine_code
Pascal's triangle/Puzzle	True	Pascal%27s_triangle
Binary digits	True	Bit
List comprehensions	False	List_comprehension
Amb	True	None
Count the coins	False	None
Magic squares of odd order	True	Magic_square
Extend your language	False	None
Narcissist	False	None
First class environments	True	Closure_(computer_programming)
Dragon curve	True	Dragon_curve
Formal power series	True	Formal_power_series
Empty string	False	Empty_string
Combinations and permutations	True	Combinations_and_permutations
MD4	True	MD4
OpenGL	True	OpenGL
Permutations by swapping	True	Permutation
HTTPS/Authenticated	True	HTTPS
Matrix-exponentiation operator	True	Matrix_exponential
Jump anywhere	False	Branch_(computer_science)
Exponentiation operator	True	Exponentiation
Pernicious numbers	True	Pernicious_number
Compare a list of strings	False	None
First-class functions	True	First-class_function
Metered concurrency	True	Semaphore_(programming)
Command-line arguments	False	Command_line_arguments
Bitwise IO	False	None
Permutations/Rank of a permutation	True	Permutation
Dynamic variable names	False	None
HTTPS/Client-authenticated	True	HTTPS
Currying	True	Currying
K-means++ clustering	True	K-means%2B%2B
Hickerson series of almost integers	True	None
Logical operations	True	Logical_connective
Bitcoin/address validation	True	Bitcoin
I before E except after C	True	I_before_E_except_after_C
Bitcoin/public point to address	True	Bitcoin
Modular inverse	True	Modular_multiplicative_inverse
Carmichael 3 strong pseudoprimes	True	Carmichael_number
Bitmap/Bresenham's line algorithm	True	Bresenham%27s_line_algorithm
Mutual recursion	True	Mutual_recursion
Bitmap/Write a PPM file	True	Netpbm
Address of a variable	False	Pointer_(computer_programming)
Create a two-dimensional array at runtime	False	Two-dimensional_array
Collections	True	Data_structure
Bitmap	True	Bitmap
Hash from two arrays	True	Hash_table
Apply a callback to an array	True	MapReduce
Flatten a list	True	None
Bitmap/Bézier curves/Cubic	True	Bézier_curve
Haversine formula	True	Haversine_formula
Parsing/Shunting-yard algorithm	True	Shunting-yard_algorithm
Generator/Exponential	False	None
Loops/Infinite	False	Infinite_loop
Loops/For	False	For_loop
Bernoulli numbers	True	Bernoulli_number
One-dimensional cellular automata	True	Cellular_automaton
Empty program	False	None
Null object	False	Null_Object_pattern
Conway's Game of Life	True	Conway%27s_Game_of_Life
Host introspection	False	None
Hough transform	True	Hough_transform
Find limit of recursion	False	None
Inverted index	True	Inverted_index
Deconvolution/2D+	True	Deconvolution
Average loop length	False	None
Arithmetic/Rational	True	Rational_data_type
Naming conventions	False	Naming_convention
Compare sorting algorithms' performance	False	Sorting_algorithm
Events	True	Event_(computing)
Memory allocation	False	Memory_allocation
Natural sorting	True	Natural_sort_order
Continued fraction/Arithmetic/Construct from rational number	True	Continued_fraction
Extensible prime generator	True	Formula_for_primes
Plot coordinate pairs	False	Coordinate_system
Named parameters	True	Named_parameter
Multiple regression	True	Multiple_regression
Add a variable to a class instance at runtime	False	None
Odd word problem	True	None
Pig the dice game	False	Pig_(dice_game)
Function definition	False	Subroutine
Maximum triangle path sum	False	None
Order disjoint list items	False	None
LU decomposition	True	LU_decomposition
AKS test for primes	True	AKS_primality_test
Check Machin-like formulas	False	Machin-like_formula
Arithmetic-geometric mean/Calculate Pi	True	Approximations_of_pi
Horizontal sundial calculations	True	Sundial
Numerical integration/Gauss-Legendre Quadrature	True	Gaussian_quadrature
Knight's tour	True	Knight%27s_tour
Miller–Rabin primality test	True	Miller-Rabin_primality_test
Go Fish	False	Go_Fish
Knapsack problem/Unbounded	True	Knapsack_problem
Spiral matrix	True	None
Read a specific line from a file	False	None
Time a function	False	None
SEDOLs	False	SEDOL
Real constants and functions	False	None
Rate counter	True	None
Zeckendorf arithmetic	True	Zeckendorf%27s_theorem
Tic-tac-toe	True	Tic-tac-toe
Rosetta Code/Fix code tags	False	None
Ranking methods	True	Ranking
Write language name in 3D ASCII	False	None
Solve the no connection puzzle	True	None
Sorting algorithms/Radix sort	True	Radix_sort
Zeckendorf number representation	True	Zeckendorf%27s_theorem
Variables	False	Variable_(computer_science)
RCRPG	False	None
Sort an array of composite structures	True	Sorting_algorithm
Voronoi diagram	True	Voronoi_diagram
Terminal control/Dimensions	False	Terminal_emulator
Runtime evaluation	False	Dynamic_programming_language
Runtime evaluation/In an environment	False	Dynamic_programming_language
SQL-based authentication	False	None
Window management	False	Window_manager
Seven-sided dice from five-sided dice	False	None
Sort stability	True	Stable_sort
Unbias a random generator	True	None
Probabilistic choice	True	None
System time	True	System_time
Statistics/Basic	True	Statistics
Rendezvous	True	Synchronous rendezvous
String matching	True	String searching algorithm
QR decomposition	True	QR decomposition
SOAP	True	SOAP
Self-describing numbers	True	Self-descriptive_number
Xiaolin Wu's line algorithm	True	Xiaolin Wu's line algorithm
Table creation/Postal addresses	False	None
URL decoding	True	URL encoding
URL encoding	True	URL encoding
Sorting algorithms/Sleep sort	True	None
Resistor mesh	False	None
Set	True	Set (computer science)
Sorting algorithms/Comb sort	True	Comb_sort
Total circles area	True	None
Rosetta Code/Find bare lang tags	False	False
Short-circuit evaluation	True	Short-circuit_evaluation
Sierpinski triangle	True	Sierpinski triangle
Sorting algorithms/Bogosort	True	Sierpinski triangle
Sorting algorithms/Permutation sort	True	Bogosort
Rename a file	False	None
Primes - allocate descendants to their ancestors	True	None
The ISAAC Cipher	True	ISAAC_(cipher)
Sudoku	True	Sudoku
Price fraction	False	None
Sequence of primes by Trial Division	True	Trial_division
Simple windowed application	False	None
Ray-casting algorithm	True	Ray_tracing_(graphics)
Remove lines from a file	False	None
Zero to the zero power	True	Zero to the zero power
Sorting algorithms/Selection sort	True	Selection_sort
Pythagorean triples	True	Pythagorean_triple
Subleq	True	Subleq
Window creation	False	Window_management
SHA-256	True	SHA-2
Web scraping	True	Web_scraping
Subtractive generator	True	Random_number_generation
Speech synthesis	True	Speech_synthesis
Sorting algorithms/Quicksort	True	Quicksort
Sleep	True	Sleep_(system_call)
Set of real numbers	True	Real_number
User input/Graphical	False	User_input
User input/Text	False	User_input
Roots of unity	True	Root_of_unity
Take notes on the command line	False	None
Primality by trial division	True	Trial_division
Rot-13	True	ROT13
Solve a Numbrix puzzle	True	None
Solve a Hopido puzzle	True	None
String length	False	String_(computer_science)
String interpolation (included)	True	String_literal
Set puzzle	False	None
Zhang-Suen thinning algorithm	True	None
Priority queue	True	Priority_queue
XML/Output	True	XML
XML/Input	True	XML
Sorting algorithms/Cocktail sort	True	Cocktail_sort
Strip a set of characters from a string	True	None
Roots of a quadratic function	True	Quadratic_function
Tokenize a string	True	Tokenize
Sorting algorithms/Counting sort	True	Counting sort
String append	False	None
SHA-1	True	SHA-1
RSA code	True	RSA_(cryptosystem)
Sum of squares	False	Sum_of_squares
Sparkline in unicode	True	Sparkline
Terminal control/Preserve screen	False	Terminal_emulator
Terminal control/Clear the screen	False	Terminal_emulator
Shell one-liner	True	Command-line_interface
Walk a directory/Recursively	True	None
Roman numerals/Encode	True	Roman_numerals
Tree traversal	True	Tree traversal
Safe addition	True	Interval_arithmetic
Yahoo! search interface	True	Yahoo!_Search
Word wrap	True	Word_wrap
Sieve of Eratosthenes	True	Sieve_of_Eratosthenes
Soundex	True	Soundex
Secure temporary file	False	Temporary_file
RIPEMD-160	True	RIPEMD
Twelve statements	False	None
Sorting algorithms/Heapsort	True	Heapsort
Temperature conversion	True	Conversion_of_units_of_temperature
Sockets	True	Transmission_Control_Protocol
Stack traces	True	Stack_trace
Sorting algorithms/Strand sort	True	None
Trigonometric functions	True	Trigonometric functions
String case	False	None
Simple database	True	Database
String concatenation	True	Concatenation
Synchronous concurrency	True	Synchronization_(computer_science)
Reduced row echelon form	True	Reduced row echelon form
Rosetta Code/Rank languages by popularity	False	None
Read entire file	False	None
Reverse a string	False	None
The Twelve Days of Christmas	False	The_Twelve_Days_of_Christmas_(song)
Sailors, coconuts and a monkey problem	False	None
Remove duplicate elements	True	None
Zebra puzzle	True	Zebra_Puzzle
Simulate input/Keyboard	False	None
XML/XPath	True	XPath
Write entire file	False	None
Stable marriage problem	True	Stable_marriage_problem
Sort an integer array	True	Sorting_algorithm
Set consolidation	True	None
Sequence of non-squares	True	None
Yin and yang	False	None
Read a file line by line	False	None
Quickselect algorithm	True	Quickselect
Sum and product of an array	False	None
Pragmatic directives	False	Directive_(programming)
Wireworld	True	Wireworld
Sorting algorithms/Stooge sort	True	Stooge_sort
Sierpinski triangle/Graphical	True	Sierpinski triangle
Substring	False	String functions (programming)
Run-length encoding	True	Run-length encoding
Update a configuration file	False	Configuration_file
Video display modes	False	Framebuffer
Terminal control/Ringing the terminal bell	False	Bell_character
State name puzzle	False	None
Return multiple values	False	None
Symmetric difference	True	Symmetric_difference
Read a configuration file	False	Configuration_file
Roots of a function	True	Zero_of_a_function
Vigenère cipher/Cryptanalysis	True	Vigenère_cipher
Show the epoch	True	Epoch_(reference_date)
Ternary logic	True	Three-valued_logic
Stern-Brocot sequence	True	Stern–Brocot_tree
Sorting algorithms/Bead sort	True	Bead_sort
Sort using a custom comparator	True	Sorting_algorithm
Send email	True	Email
String comparison	True	String comparison
Quaternion type	True	Quaternion
Strip control codes and extended characters from a string	True	None
World Cup group stage	True	None
Rock-paper-scissors	True	Rock-paper-scissors
Variable size/Set	False	None
Sum multiples of 3 and 5	True	None
Power set	True	Power set
Program termination	False	None
Truncate a file	False	File_system
Rosetta Code/Count examples	False	None
Variadic function	False	Variadic_function
Write float arrays to a text file	False	None
Topic variable	False	None
Ulam spiral (for primes)	True	Ulam_spiral
Stack	True	Stack_(abstract_data_type)
Terminal control/Display an extended character	False	Terminal_emulator
Terminal control/Inverse video	False	Terminal_emulator
Terminal control/Hiding the cursor	False	Terminal_emulator
Sum of a series	True	Sum of series
Universal Turing machine	True	Universal_Turing_machine
Test a function	False	Software_testing
Send an unknown method call	False	Higher-order_function
Vogel's approximation method	True	None
Trabb Pardo–Knuth algorithm	True	Trabb_Pardo–Knuth_algorithm
Singly-linked list/Traversal	True	Linked_list
Roman numerals/Decode	True	Roman_numerals
Program name	False	None
Queue/Definition	True	Queue_(abstract_data_type)
String prepend	True	Concatenation
Strip whitespace from a string/Top and tail	True	Trimming_(computer_programming)
Special variables	False	None
Sorting algorithms/Pancake sort	True	Pancake_sorting
Quine	True	Quine_(computing)
Top rank per group	False	none
Verify distribution uniformity/Naive	True	Distribution_uniformity
Sorting algorithms/Insertion sort	True	Insertion_sort
Sorting algorithms/Bubble sort	True	Bubble_sort
Verify distribution uniformity/Chi-squared test	True	Chi-squared_test
Random numbers	True	Random_number_generation
XML/DOM serialization	True	Document_Object_Model
Terminal control/Coloured text	False	Terminal_emulator
Vigenère cipher	True	Vigenère_cipher
Text processing/2	False	None
Visualize a tree	True	Tree_view
Unicode strings	False	None
Textonyms	True	Predictive text
Same Fringe	True	None
Primorial numbers	True	Primorial
Sorting algorithms/Shell sort	True	Shellsort
S-Expressions	True	S-expression
Sierpinski carpet	True	Sierpinski_carpet
Scope modifiers	False	Scope_(computer_science)
Sorting algorithms/Gnome sort	True	Gnome_sort
Van der Corput sequence	True	Van_der_Corput_sequence
Text processing/Max licenses in use	False	None
Unicode variable names	False	Unicode
Polynomial regression	True	Polynomial_regression
Standard deviation	True	Standard deviation
Thiele's interpolation formula	True	Thiele%27s_interpolation_formula
Runge-Kutta method	True	Runge–Kutta_methods
Sum digits of an integer	True	none
Random number generator (device)	False	Hardware random number generator
Self-referential sequence	True	Self-reference
Record sound	False	Sound_recording_and_reproduction
Stem-and-leaf plot	True	Stem-and-leaf_display
URL parser	True	Uniform_Resource_Locator
Scope/Function names and labels	False	None
Polymorphism	False	None
Solve a Hidato puzzle	True	Hidato
Unix/ls	True	Ls
Stair-climbing puzzle	True	None
Text processing/1	False	None
Special characters	False	None
Rep-string	False	None
Truncatable primes	True	None
Semordnilap	True	Semordnilap
Semiprime	True	Semiprime
Range expansion	True	None
Range extraction	True	None
Regular expressions	True	Regular_expression
Vector products	True	Vector_product
Prime decomposition	True	Prime decomposition
Singleton	True	Singleton_pattern
Variable size/Get	False	None
Sort disjoint sublist	True	None
Start from a main routine	False	None
Respond to an unknown method call	False	None
Reverse words in a string	True	None
Simulate input/Mouse	False	Computer_mouse
Terminal control/Cursor movement	False	Terminal emulator
Zig-zag matrix	True	None
Rosetta Code/Find unimplemented tasks	False	None
Terminal control/Positional read	False	Terminal emulator
Problem of Apollonius	True	Problem_of_Apollonius
Topological sort	True	Topological_sorting
Terminal control/Cursor positioning	False	Terminal emulator
Search a list	True	Linear_search
Terminal control/Unicode output	False	Unicode
Sutherland-Hodgman polygon clipping	True	Sutherland–Hodgman_algorithm
Solve a Holy Knight's tour	True	None
Window creation/X11	False	X11
Vampire number	True	Vampire_number
Use another language to call a function	False	Foreign_function_interface
Random number generator (included)	True	Random_number_generation
Towers of Hanoi	True	Tower_of_Hanoi
Repeat a string	True	None
Sokoban	False	Sokoban
Polynomial long division	True	Polynomial_long_division
Queue/Usage	True	Queue_(abstract_data_type)
Undefined values	False	Undefined_value
Y combinator	True	Fixed-point_combinator
Singly-linked list/Element insertion	True	Linked_list
Substring/Top and tail	False	None
Singly-linked list/Element definition	True	Linked_list
Variable-length quantity	True	Variable-length_quantity
Write to Windows event log	False	Event_Viewer
Strip block comments	True	Block comments
Sorting algorithms/Merge sort	True	Merge_sort
Walk a directory/Non-recursively	True	None
Strip comments from a string	True	Comment_(computer_programming)
Topswops	True	None
